LRRRLLRLLRRLRLRRRLRLRRRLRRLLRRRLRRLRLLRLLRRLRLLLLRRLRRLRLLRRLRRRLLLRRLRLRRLRRRLRRRLLRLRRRLLRRLRRRLRRLRLRRLRRLLRLRLRRRLRRLRRLRRRLRRLRRLRLRRRLRRRLRRRLLLRLRRLRLRRRLRRRLRRLRRLLRLRRLLRRLLRLRRLRLRRLRRRLRLRRLRLRRRLLRRLLRLRRRLRRRLRRRLRRRLLLRLRRLRRRLRRRLRLLRRLLRRLRLRLLRRLRRLLRRRLRLRRRLRRRR

IYD = (UAD, OOE)
AWX = (ACJ, GJR)
HPD = (DVL, PIH)
SPB = (2GT, RNK)
FEW = (XHQ, XNM)
TTH = (IVM, WMJ)
CNJ = (OJO, HVQ)
XBZ = (LLK, RHZ)
CGW = (SMY, PDC)
LPY = (CRP, UUZ)
ASI = (DYF, CZS)
QKN = (FPJ, AVF)
ZKX = (QTG, YID)
BKC = (UHJ, BKC)
DVL = (2ZG, 3MC)
ZBV = (HRH, YLF)
AUV = (FXQ, AWE)
TFK = (XGS, IZS)
SPI = (TDT, 2DE)
1JG = (XQL, CJB)
SQM = (GPD, NHG)
YHB = (RDG, PFS)
LQT = (GBG, CCC)
NUH = (YNC, TVZ)
KNS = (LRW, 1AE)
SWF = (XJW, HVT)
VWH = (EGV, XFV)
VOB = (BYG, RZL)
VAK = (HSK, CBV)
RTS = (1WS, NVN)
2UR = (HJB, IXL)
NQT = (TWN, 2EC)
ABB = (GMJ, GPU)
WIW = (JYA, JZP)
WYA = (GVM, NDC)
APN = (1MK, ULA)
1BB = (RHZ, UAD)
KAR = (CMD, PIH)
DOH = (VQO, BKR)
KBI = (ETJ, ICZ)
LJV = (TIB, RZV)
OLL = (ESA, FPJ)
XSU = (YZU, WSZ)
TIB = (EBO, PGJ)
QTU = (OWB, LRW)
AHH = (REO, PGJ)
VCV = (YVP, BDB)
2FA = (MLM, 1JG)
AOO = (KKB, ZKF)
PIH = (TVE, KKC)
OAU = (HNE, VTT)
RZL = (XNM, PKB)
VRD = (IJH, MYL)
2US = (WVM, VEM)
DYF = (ZKX, OWM)
FDH = (ZFY, HJP)
ABM = (YLF, YAV)
3PL = (DIG, KKB)
NCP = (ULR, OAK)
PDP = (VQO, EQY)
EJT = (EWD, CLN)
QCF = (UBL, XND)
FNL = (RZF, 1LN)
PDC = (HVT, NCP)
UNC = (OLI, IVM)
3MV = (XKN, DRX)
DTA = (YLF, YTW)
OWM = (ZWE, ECQ)
1PJ = (QHE, TVE)
DWI = (YYX, 2GZ)
MAU = (GXW, 2US)
JCR = (2GT, BJD)
YIR = (KKO, FRO)
VSL = (TCJ, IQJ)
FTU = (PQL, WVM)
NHG = (HIF, RZF)
BDB = (DUD, YPO)
XEP = (YPY, FHE)
3ZK = (SCP, PSO)
UZF = (USS, UKE)
TUS = (GSV, HTL)
PBD = (TMP, XWG)
GVY = (3SW, YZU)
NBE = (KKE, IHP)
QQL = (KIU, PDC)
JBD = (LLR, RUM)
KVZ = (PKQ, YAV)
JAN = (PHE, YVM)
TBL = (XBZ, FYA)
TMO = (XAR, CZX)
QRY = (EGV, CZS)
JNY = (MFB, EQY)
TDU = (NVN, PIH)
GXW = (LFJ, PGJ)
CTE = (DRK, MSI)
SVX = (LYB, APN)
XHQ = (QPD, EZG)
CCC = (GKL, OKG)
HOY = (NVQ, ZKB)
ZUJ = (1KX, ATL)
VVY = (HLI, TSA)
QFW = (LRW, HVQ)
ZDO = (IEC, LJX)
MVZ = (HPD, VQO)
MLM = (CYO, LKA)
EXP = (VQX, LBN)
ZII = (OWM, FEW)
LYB = (LFJ, YTJ)
PFS = (MAX, OAK)
2LX = (WFV, DIG)
IVX = (RYY, QLQ)
2JO = (CLN, 3SW)
KAY = (IDB, TCJ)
JIM = (BKP, DRK)
SFG = (PIT, MZA)
EMR = (1LN, 1MI)
CIA = (DLB, 1MK)
SMA = (APG, BFL)
JLV = (GJR, AFK)
VTP = (GDF, XZY)
EGV = (2FA, NDK)
PZI = (UNC, TDU)
GXB = (ZII, GVM)
2JD = (FHE, FLY)
SOO = (WTS, OAU)
NVQ = (YRT, 1KT)
VHJ = (3QH, UCG)
ORJ = (LTU, KTJ)
ATL = (PHE, GVN)
RUT = (AHH, UCG)
IZS = (HZS, ARS)
2YK = (KEH, ZED)
ZPH = (CRP, IWE)
AUZ = (ARS, TGX)
RDG = (QTU, ZAN)
IWI = (IFO, CVK)
LJX = (JAE, VQZ)
TRQ = (GMO, XPK)
DBC = (GVM, AHH)
2QF = (IAV, SOO)
RYQ = (YLF, DHU)
YZU = (AYW, VUG)
JBT = (BDB, RTS)
IAV = (KXP, EQE)
UFN = (DNN, FVC)
SEH = (3QH, 1JM)
LTI = (KNS, ZKB)
HVN = (1JG, CZS)
2DE = (FKI, CCC)
NMM = (COH, SML)
KPD = (PKQ, ZWE)
LZS = (CBM, 1XZ)
2WJ = (RDG, YAV)
RER = (3CX, YIE)
RHC = (SST, 2WJ)
UCG = (HLJ, LBN)
KIT = (KWV, HIF)
YLQ = (LLR, UTI)
QDR = (YZG, TIB)
QOT = (1MK, EUB)
CJB = (2MP, XBJ)
MAX = (NSO, EAX)
XUX = (EZG, YHB)
PHF = (ZAN, PVM)
AUQ = (3XZ, UZF)
NNZ = (NNR, QLQ)
VBQ = (NVF, GKL)
COH = (EGN, TBL)
WJT = (ESS, LEE)
HAR = (OBF, YTW)
2JH = (JBT, MDG)
EIU = (3SW, RDG)
TGF = (2BY, YIR)
LPF = (CDZ, WIW)
XWG = (BJD, PTY)
YTW = (QQL, EQC)
1NH = (PLU, KPD)
RZF = (TDT, LDZ)
WJE = (MJK, KWK)
YID = (ABM, ERK)
1DC = (VTP, KKO)
OKG = (JAN, 2MP)
QHB = (ESA, HRH)
UTI = (NMW, 2BY)
1SD = (XBZ, OOE)
PBG = (TQY, OPN)
YTJ = (TSA, LIQ)
BBM = (RTS, 2NV)
BMS = (FJF, TMO)
BHQ = (IJH, MFB)
DNW = (GVM, DHY)
EYL = (UDU, BZH)
QQC = (INW, VEM)
VSC = (1LL, PFS)
LBN = (WPB, OPN)
YNC = (1IU, GCI)
HRH = (PBR, KQG)
DKT = (ZAN, DTP)
OKV = (VUG, IJH)
IVQ = (TUS, KYL)
FVD = (LLR, 3JR)
GSV = (SZS, GPT)
3PA = (QQK, PDP)
XPK = (ULV, CLN)
OWY = (WMJ, CVK)
GBG = (KKC, KWV)
MYL = (YYI, ONX)
OAK = (GSV, UAD)
QQK = (OKV, 1ZP)
RUM = (SVX, VOW)
FKI = (QQV, OER)
PKB = (1IU, ABB)
SSN = (AWE, UHJ)
ZWE = (EZG, 1SD)
JYA = (XEE, XZY)
OBF = (YIE, 1KT)
BVX = (PTY, 2MP)
YVP = (XFT, UUM)
GVN = (HPD, RUT)
CXF = (2GT, KAN)
KQX = (EXP, WJE)
PWN = (PDP, PXA)
GPD = (UAH, VHJ)
HZO = (WRK, RER)
ZFW = (JPJ, TVZ)
HLJ = (PPV, WWU)
JTG = (CVK, OWB)
LTU = (ADP, BDB)
YRT = (HLI, GVM)
ZMU = (PGJ, ULA)
QYI = (CTE, UHJ)
WVN = (HVQ, APN)
VKE = (TGX, GKL)
YLF = (USS, VTP)
WVD = (UUZ, UTI)
3TT = (NVN, EAX)
ECQ = (XZY, 3OI)
BQZ = (BXF, SIQ)
NPI = (RTD, EJF)
3UM = (JJH, ATL)
NDK = (FYM, PFS)
MWP = (FVD, CRU)
TAI = (WJE, GVN)
XZY = (KQG, GMJ)
3MU = (OWM, QQV)
IWG = (MYV, 1LN)
3QH = (APN, OHW)
EJF = (ESA, TGX)
DLB = (WPB, XJI)
DNN = (GMJ, FHV)
WFV = (TAD, IJH)
QWS = (PPV, FJF)
1MK = (FUB, SWC)
BXJ = (SPI, CVK)
HVM = (KAN, BHQ)
SML = (USK, VSC)
1ZP = (ONX, KAY)
ZQL = (RYQ, KYM)
1VR = (INW, MWP)
TCJ = (3JR, 3NE)
ADT = (2KQ, FXN)
FRO = (XBJ, NQT)
ULR = (3SN, FSS)
HPW = (1EQ, KAR)
FHV = (KAY, TXC)
1XY = (QQK, EUB)
MYV = (FKI, ORJ)
MVW = (PFS, LTC)
AFK = (NPI, PFS)
LPP = (CIA, BZH)
FBT = (OWM, RYY)
KTJ = (GVM, LZS)
WTS = (HVT, NPI)
XQL = (AGR, RGX)
ADP = (GXW, NQT)
TDT = (EJF, RUW)
1MI = (QFW, TTH)
MLT = (ESS, OPN)
GCI = (BYE, UZF)
HIF = (BKP, HJP)
WSZ = (XEE, EAW)
KWV = (OCP, UNC)
OOE = (2US, PZI)
XKN = (GSV, TQV)
FAG = (LDD, EWZ)
KAN = (ZFW, CKG)
BJI = (ZZZ, EVM)
RUW = (ZKF, YTJ)
FXN = (VQZ, KWV)
BKP = (FHV, JIM)
RNN = (AVF, 2LM)
2ZG = (DTS, RNK)
NVN = (CLN, NNR)
2GZ = (VKU, YEL)
CKG = (MVZ, OHW)
ZXT = (GSV, PNZ)
EUB = (SIQ, PGJ)
PNZ = (3ZF, UAH)
GDF = (SXZ, GDF)
3XZ = (ZZZ, XPK)
RBU = (BHU, DUD)
SDD = (TWN, PDP)
MCN = (CTE, JAN)
3SW = (AGR, ORJ)
RWA = (EWD, 3SW)
HJZ = (JZP, QAM)
VQX = (TLM, PDP)
HNE = (UHP, PNZ)
HVT = (XOA, HNC)
1SF = (DWI, JNY)
TXC = (LKA, RZF)
IIU = (SEE, QTG)
MRO = (3SW, HIF)
INW = (ICZ, MPF)
USW = (PKQ, UXO)
GKL = (UBL, 2LM)
ICZ = (UFN, RHZ)
BRV = (IJH, AUZ)
IVY = (GSV, KXP)
1XZ = (LPP, RTS)
LHG = (WPB, YRT)
MDG = (2QF, RER)
CBM = (ZED, EIU)
ZOG = (MRO, VAK)
YPO = (XZY, SSN)
XJW = (BJD, EMR)
PTY = (PGJ, LLK)
3OI = (ASI, OIC)
IJH = (IEC, LQT)
OWS = (OWS, PKB)
YAV = (EGH, ORJ)
WYC = (ZKF, ASY)
ZFY = (XNC, YNC)
EGH = (FYA, ULV)
GJK = (FYM, BXJ)
ESS = (QTU, RWA)
OFQ = (WMJ, 1WS)
OIC = (DTA, TWN)
BYE = (1MI, ZDA)
GPT = (EYL, EZG)
QQV = (SCP, GGP)
JIU = (IIU, JVK)
CBV = (ZXT, KEH)
IEC = (KAR, JDX)
BZH = (LYB, HVM)
PSO = (AYW, ZJR)
GGP = (JDX, LLR)
2GT = (BKR, IWE)
USK = (RZV, VWH)
GSS = (JNC, RYQ)
DFQ = (THR, 3TT)
2MP = (AYW, XKN)
UUM = (NUH, FDH)
XMH = (NNR, GZQ)
PBR = (HRH, DFQ)
ZAN = (GGH, AFK)
ZXQ = (RUT, NDC)
IJF = (TQV, XEE)
UUZ = (IAV, QQV)
IVM = (WYC, FXQ)
CUI = (ZPH, RNI)
TLM = (JYA, GXB)
HZS = (LDD, ICZ)
1LL = (QOT, NXB)
UDU = (ZUP, NUH)
JDX = (3SW, OWS)
CYY = (NCP, 1DC)
IFO = (DWI, NVN)
XEE = (DWO, CJB)
AAC = (HSK, JLV)
CUQ = (BFL, BKC)
DTS = (ULV, HRA)
BHU = (QPO, ZFY)
LFJ = (IVT, GBG)
AVF = (GPD, 2BU)
XGS = (AUV, XFT)
NTL = (VTT, 2US)
ZED = (EGV, 2LX)
OWA = (PBG, CKG)
QLQ = (3ZK, ACJ)
2NV = (3ZK, QRY)
NVF = (1JG, 2FA)
3ZJ = (MFB, BYE)
VHS = (VVY, NDK)
MDH = (AUV, CYO)
ZKF = (WKX, XFT)
HVQ = (3MV, TFG)
LIQ = (3US, 1LL)
QHA = (WGP, EZG)
LEE = (RUT, HJZ)
3NY = (SCP, UNX)
UVT = (OWY, MAX)
GRZ = (MAU, 2GZ)
KYM = (YIR, UUZ)
CRP = (ZQL, KWV)
QHE = (LQT, UTI)
CWL = (FXN, JIM)
IKK = (MSI, IVM)
XNM = (OAT, NTS)
OPN = (PDC, ZUP)
QPD = (SCP, YLS)
DLV = (IQJ, FXN)
VKN = (HOY, YID)
ASY = (QHA, HVM)
TSA = (IDB, UAH)
WPB = (AVF, JAE)
RNK = (SJR, KHF)
SIQ = (QQV, BVX)
NDC = (PLU, OWY)
VQO = (ABM, SMY)
QJP = (XNM, SQM)
ZZZ = (TVE, WJT)
DVR = (3PA, TDU)
WVM = (FDH, WWU)
KKC = (KKB, ECQ)
TQY = (CRT, ZMU)
FXQ = (UXO, FLR)
MTC = (YPY, MAJ)
PPV = (YRT, DVR)
JZP = (2BY, BMN)
YIE = (ATL, 1XZ)
PXA = (IFO, WWO)
EVM = (KCW, QWS)
JJH = (WVD, MAJ)
USB = (WVN, MAU)
WMY = (UNC, BMS)
LLK = (BPW, ZPH)
MZA = (YCA, SMW)
NAX = (DTP, TXC)
GVM = (DKT, XHQ)
VXI = (JCR, AHH)
ZUP = (QLQ, 3US)
GJR = (HRA, TFK)
PKQ = (3ZJ, OLL)
QWH = (TCJ, IDB)
SJR = (EQE, XJO)
DRX = (BBM, ADP)
1LV = (MYL, 2WI)
FLY = (DWE, VRD)
JOB = (3ZG, XNM)
ULA = (HAG, GMO)
HNV = (BXA, CTE)
HJX = (DHY, NTS)
FVC = (IVX, XBJ)
XIF = (WHI, QPD)
QFZ = (BZH, GPU)
WKX = (HRA, SIQ)
UAH = (QOT, GZQ)
VIF = (CBV, JNY)
KXP = (GXB, JNY)
OIZ = (UHJ, MDG)
QQX = (HVQ, ZWE)
RME = (WHI, UAH)
ETJ = (AAC, EUB)
LXL = (ZKF, KBI)
3UQ = (JAN, MVW)
KKO = (SMW, 1BB)
CDZ = (EAX, SVX)
3US = (UDY, LEM)
GPU = (WJT, GRZ)
FSS = (1XY, XBZ)
CMD = (DVR, NTL)
JNC = (IJH, YVM)
UXO = (MZA, 1LV)
OCP = (DRK, UAQ)
3CX = (VIF, 1NW)
ZBC = (XJO, MXQ)
PGJ = (XJW, NNR)
JAF = (WWU, 2WJ)
KKB = (EQE, 3OI)
TGX = (OWS, BBM)
MPF = (PPV, ESS)
KAA = (2EC, CRT)
XXB = (JZP, HLJ)
YPY = (IZR, TMP)
BYG = (3ZF, EGN)
2LM = (WPB, SZS)
XND = (2BY, MTC)
RYY = (PHF, OJO)
HNC = (EWD, WIW)
APD = (FHV, UHJ)
HJP = (BJD, WVM)
HJB = (LLK, FLY)
LRW = (PKB, FVC)
3SN = (ETJ, FXK)
DTP = (HNE, AWX)
PIT = (NNR, 2MP)
BKO = (WPG, OAK)
MMD = (RME, IJN)
GQC = (DWI, QLQ)
EAW = (KQG, ZPH)
YIN = (WRH, TVE)
PVM = (NHG, VWH)
LQO = (KAR, 3UQ)
PHX = (XZY, ESS)
BXA = (CUQ, PKB)
JNQ = (SMW, HNE)
RLJ = (2LX, IZR)
ONX = (EIU, 2LM)
VKU = (KKE, NTS)
JVK = (GSS, KAR)
SWC = (HRA, GGH)
3NE = (KVZ, 3OI)
DHU = (QOT, UVT)
EWD = (FXK, XNC)
3PP = (ECQ, CRT)
AXU = (2MP, WKX)
ZRM = (FBT, CGW)
NNR = (EGN, YLQ)
BXF = (XHQ, OPN)
IWE = (ZII, IVM)
2WW = (VQZ, OWY)
FJF = (BPK, UVT)
RPB = (FAG, QJP)
SZS = (IVQ, VSL)
ECI = (ZTS, TXC)
ZTS = (BXJ, TQV)
XJI = (OPN, WWU)
VOW = (1GA, DHU)
DMZ = (LDZ, ZVK)
JFS = (DYF, OCP)
SEE = (CBM, OPN)
PHE = (MAX, EUB)
UBL = (FEW, LPF)
XJO = (JYA, AAA)
SMY = (3UM, DRX)
OAT = (YLF, JKZ)
MGS = (FLY, KAA)
GXA = (3MU, LYB)
EZG = (RHZ, BZH)
PQL = (IVT, UAD)
RHZ = (EGV, PLU)
ACJ = (HNE, 3XZ)
UKE = (UAQ, ZPH)
PKK = (BYG, KVZ)
YZG = (WJE, PZI)
UAD = (QQC, ZZZ)
FYA = (VSL, 1MI)
QAM = (JFS, BYE)
GZQ = (DHU, HVQ)
HRA = (XXB, THR)
WMJ = (SFG, ZBC)
BRT = (YZK, AYW)
LLR = (2GT, 2WW)
WHI = (XWG, BKO)
HLI = (DFQ, OFD)
MYY = (2KQ, 1IU)
SBU = (CVK, 3US)
HTL = (CTE, ATL)
VUG = (WTS, ECI)
NRD = (LEM, YEL)
XFV = (YRT, 2YK)
KHF = (BKO, MYV)
KYL = (1WS, FVD)
CZS = (QLQ, UUZ)
JXL = (QLQ, JAN)
WPG = (NNZ, HLI)
TVZ = (VUR, 2KQ)
WGP = (RZF, XPK)
CLN = (XUX, KEH)
1KX = (LXL, 2ZG)
OLI = (QQC, YNC)
MAJ = (3SN, WWO)
1GA = (XND, 1CO)
IZR = (WIW, NVQ)
KIU = (CWL, BMN)
UAQ = (OWA, JXL)
NMY = (2JH, ATL)
CZX = (3ZK, MRO)
2ZB = (1PJ, ZDA)
CYO = (KAN, GGP)
IXL = (BFL, 3JR)
KKE = (YLS, XEE)
PFW = (IFO, MYV)
QQJ = (XFV, TFW)
OER = (FXK, NTL)
LDD = (JNQ, MAJ)
SIK = (YIE, NMM)
TAD = (GZQ, TFG)
WGQ = (YZU, FTU)
2BY = (1JM, FEW)
CKR = (3MU, 2ZB)
1CO = (SWJ, RWA)
QTG = (PHE, UKE)
BFL = (IJH, SVX)
UNX = (HNC, UUZ)
IWA = (BJD, LQT)
IHP = (DWE, XND)
JAE = (AAA, SPI)
USS = (UAD, ADP)
VEM = (1LN, REO)
VQZ = (AWE, LPF)
NSO = (2EC, PGJ)
NHJ = (XUX, REO)
REO = (WKX, EQE)
GVX = (QHA, PFW)
ZJR = (MLT, PQL)
2KQ = (PBR, JNQ)
YEL = (IVT, ZKX)
DRK = (ABM, HNC)
MSI = (2JD, LDD)
XFT = (2MP, KAR)
SCP = (NDK, UDU)
OHW = (OLL, OAU)
GGH = (YVP, IVT)
NKV = (PKQ, QHB)
YVM = (3CX, 2US)
PLU = (EGH, UUM)
IJN = (JTG, KAR)
3MC = (DHU, CMD)
FXK = (BZH, KWV)
FDX = (DTA, XNM)
2EC = (JVK, SPI)
3ZF = (BDB, BHU)
3FB = (IXL, COH)
YBH = (GVY, GVX)
3BD = (PQL, 2IL)
LBH = (WWO, MJK)
UHJ = (VVY, RNK)
3JO = (QQL, OKV)
ARS = (AUZ, YIE)
KEH = (YID, OAK)
BVY = (IVX, 1DC)
JKZ = (WDR, 2EC)
YLS = (BHQ, 1PJ)
WWO = (NMY, APN)
1LN = (MLM, WJF)
BMN = (JIM, KAA)
OHH = (DWM, KKO)
SXZ = (FBT, XFV)
ZDA = (NRD, SMW)
TFW = (WGQ, 2EC)
1KT = (LQO, SCP)
FLR = (EQC, NTS)
DUD = (WMY, ETJ)
VUR = (1NH, JIU)
UHP = (KWV, KNS)
SPV = (TMO, FJP)
RZV = (ECI, WYA)
KWK = (VWH, DBC)
DHY = (HSK, 1BB)
MTE = (IWA, FPJ)
XBJ = (HSK, RYQ)
IQJ = (KQG, VKE)
HDU = (OFD, KKB)
XOA = (JTG, TUS)
RNI = (XSU, KXP)
DIG = (1DC, ZKF)
DLJ = (QAM, QTU)
1WS = (ZWE, 2EC)
DWM = (3MC, UFN)
NZA = (NMW, ADP)
VSA = (HSK, BXF)
MRR = (OKG, ZBV)
LTC = (SIQ, GRZ)
YYI = (SPB, NBE)
FQZ = (GKL, 1LL)
AWE = (IVX, CGW)
EGN = (YVM, MVW)
CVK = (XQL, TAD)
FYM = (KCW, GVX)
DWO = (HNE, KKC)
EQC = (APN, YTW)
HAG = (1LL, VEM)
IDB = (WJF, BQZ)
WRH = (JJH, EJT)
1JM = (SVX, QQL)
QPO = (PZI, XQL)
ERK = (QTG, HPW)
LEM = (YLF, NHJ)
YCA = (CMD, YIR)
NTS = (UHP, FXN)
EWZ = (ADT, ZBC)
WWU = (JPJ, GPT)
RPP = (JIU, YPO)
GKE = (FHV, LEM)
2IL = (YCA, 2LM)
MJK = (1LL, IVX)
MXQ = (EAX, ZJR)
GMO = (ULA, GSS)
THR = (SML, AVF)
KCW = (2EC, HLJ)
3ZG = (OAT, UUM)
FJP = (QJP, TBL)
SMW = (2BU, ZII)
SWJ = (UAQ, JSW)
JQO = (WJT, FVD)
TVE = (IYD, 3UM)
YYX = (VKE, MTE)
FUB = (MYV, JZP)
AYW = (BXF, 1MI)
BPW = (XEE, HIF)
RGX = (DNN, MLM)
1IU = (YPY, RTS)
VTT = (OER, 3SW)
WJF = (YYX, 3US)
OJO = (DIG, IWG)
WPL = (2WW, PIT)
FHE = (YVP, QHB)
EBO = (2FA, UAQ)
CRT = (1NH, MJK)
BKR = (OKV, KKB)
BJD = (JCR, ASI)
2XN = (SPB, CYY)
MFB = (JXL, GGP)
TFG = (BBM, PFW)
UDY = (2JO, JBD)
EQY = (MYV, LLK)
YZK = (PBR, RUM)
3JR = (FBT, QTG)
XAR = (1CO, DOH)
SST = (NTS, YPY)
HSK = (KAA, YHB)
1AE = (MSI, EGH)
EAX = (JNC, QRY)
EQE = (AOO, DVR)
FPJ = (ESS, WMY)
ESA = (YZG, TLM)
AGR = (HDU, XEE)
2BU = (DTP, XJI)
DWE = (WVM, THR)
TQV = (RGX, OWY)
ZVK = (OHW, CKR)
KVQ = (VCV, JIU)
WDR = (WJT, FXK)
AAA = (JLV, FXQ)
TMP = (QPO, OOE)
NMW = (APD, AXU)
KQG = (IJH, TIB)
RTD = (MYV, WJT)
JPJ = (OFQ, DMZ)
1NW = (XJW, 3MV)
BPK = (VTP, FDX)
TWN = (VBQ, PIH)
ZKB = (1XZ, 3QH)
LDZ = (YZG, TAI)
YBZ = (MYY, JOB)
JSW = (1ZP, HNV)
XNC = (ATL, UBL)
1EQ = (KAR, KBI)
RBH = (CWL, WFV)
NXB = (2QF, AXU)
APG = (XGS, SCP)
OWB = (IVX, WYA)
OFD = (ZVK, IWA)
IVT = (FXQ, FEW)
ULV = (XBZ, EQE)
CRU = (ZII, WRK)
JSI = (TGX, KYL)
LKA = (QOT, RYQ)
WRK = (1VR, DVL)
GMJ = (AAA, BDB)
2WI = (ZDA, YZU)
NWU = (SPI, QFZ)
